 |A B C D E F G H
-+---------------
1|. . 2 o . . . .
2|. . 2 . . . . .
3|. . . 3 3 3 . .
4|. . . . . . . .
5|. . . . . . . 4
6|. . . . . . . 4
7|. . . 5 5 5 5 5
8|. . . . . . . 4